12
7
3
011111111110
011111111110
000000021110
000000021110
000000021110
000000001110
000000000000
000000000000
000000000000
000000200000
000000200000
000000200000
000000000000
000000000000
000000000000
011110000000
011112000000
011112000000
011112000000
011110000000
000000000000